NO ./images/37_texture.png
SO ./images/38_texture.png
WE ./images/39_texture.png
EA ./images/40_texture.png


F 44,60,81
C 135,210,235


11111111111111111111111111111111111111111111111110111111111
10000010101010101010000000000000001010001010101010101010101
10100010101010000000001010101010001010101010100000000000001
10100010101010101010001010101010001010101010111111000011111
10100000000010101010001010101010001010101010001010100010101
10100010100010101010001010101010000000010000001010100010101
10100010100000000000000000000000001010101010101010100010101
10000010101010101010100010101010001010101010101000000010101
10100010101010101010100010101010000000000000101010100010101
10100010101000000010100010101010101010101000001000000000101
1S100010101011100011101000001010101010101000101010101000101
10100010111010100010101010001010101010101000101010101000101
10100000000000000010101010000100000010101000101000100000101
10101000101010101010101010001 10100010101000101010101000101
10101000101010111010101010001 10100010101000101010101000101
10101000101010101010101010001 10100010101000101000000000101
10101000101000000000000100100100000010101000101000101010101
10000000101000101010101010101010001010101000000000101010101
10001010111000101010101010101010001010101000101000000000101
10001010101000101010101010111010001010101000101010101000101
10000000101000000000000000001010010000101000101010101000101
10101000101010101000101010001010111000101000101000000000101
10101000101110101000101010001010101000101000101000101010101
10101010001000000000101010000000000000000000101000000000001
11111111111111111111111111111111111111111111111111111111111