SO ./images/37_black.png
NO ./images/37_texture.png
WE ./images/39_Black.png
EA ./images/40_texture.png

C 135,210,gbxfgnvxdnxgvbfg235
F 44,60,81

1111111111111111111111111111111111111111111111111111111111
1000001010101010101000000000000000101000101010101010101011
10100010101010000000001010101010001010101010100000000000001
10100010101010101010001010101010001010101010111111000011111
10100000000010101010001010101010001010101010001010100010101
10100010100010101010001010101010000000010000001010100010101
10100010100000000000000000000000001010101010101010100010101
10000010101010101010100111110101010100010101010101010000001
10100010101010101010100010101010000000000000101010100010101
1010001010100001001100010101010101010101000001000000000101
1000010101011100011101000001010101010101000101010101000101
10100010111010100010101010001010101010101000101010101000101
10100000000000000010101010000100000010101000101000100000101
10101000101010101010101010001 10100010101000101010101000101
10101000101010111010101010W01 10100010101000101010101000101
10101000101010101010101010001 10100010101000101000000000101
10101000101000000000000100100100000010101000101000101010101
10000000101000101010101010101010001010101000000000101010101
10001010111000101010101010101010001010101000101000000000101
10001010101000101010101010111010001010101000101010101000101
10000000101000000000000000001010010000101000101010101000101
10101000101010101000101010001010111000101000101000000000101
10101000101110101000101010001010101000101000101000101010101
10101010001000000000101010000000000000000000101000000000001
11111111111111111111111111111111111111111111111111111111111