NO ./images/39_black.png
SO ./images/40_black.png
WE ./images/41_black.png
EA ./images/42_black.png
F 220,100,0
C 225,30,0
        1111111111111111111111111
        1000000000110000000000001
        1011000001110000000000001
        1001000000000000000000001
1111111110110000011100000000000001
100000000011000001110111111111111
11110111111111010001110010001
11110111111111011101 10010001
11000000110101011101110010001
10000000000000001100000010001
10000000000000000101010011001
1100000111010101111100000S0111
11110111 1110101 10111101100001
11111111 1111111 11111111111111